[
	"GGGGGGGGGGGGGGGGGGGGGGGGGGGGGGGGGGGGGGGGGGGGGGGGGGGGGGGGGGGGGGGGGGGGGGGGG",
	"GL.......2.BBBBBBBBBB2.2.WWWWWWWW4..B4..BBBBBBBB2.2.BBBBBBBBBB2.L.......G",
	"G........x.BBBBBBBBBBx.x.WWWWWWWW...B...BBBBBBBBx.x.BBBBBBBBBBx.........G",
	"G1111111zC.a11111111zC.C.a111111zd..vd..a111111zC.C.a11111111zC.a1111111G",
	"G.......................................................................G",
	"GBBBBBBBBb.BBBBBBBBBBb.b.BBBBBWWW4..B4..BBBBBBBBb.b.BBBBBBBBBBb.BBBBBBBBG",
	"GBBBBBBBB2.BBBBBBBBBB2.2.BBBBBBWW...B...BBBBBBBB2.2.BBBBBBBBBB2.BBBBBBBBG",
	"GBBBBBBBB2.BBBBBBBBBB2.2.BBBBBBBW4..B4..BBBBBBBB2.2.BBBBBBBBBB2.BBBBBBBBG",
	"GBBBBBBBBx.BBBBBBBBBBx.x.BBBBBBBB...B...WWBBBBBBx.x.BBBBBBBBBBx.BBBBBBBBG",
	"G1111111zC.a11111111zC.C.a1111111d..ed..1111111zC.C.a11111111zC.a1111111G",
	"G.......................................................................G",
	"G1111111zC.a11111111zC.C.a1111111d...d..1111111zC.C.a11111111zC.a1111111G",
	"G.......................................................................G",
	"GBBBBBBBBb.H.........b.b.BBBBBBBB4..B4..WWWWWWWWb.b.BBBBBBBBBBb.BBBBBBBBG",
	"GBBBBBBBB2...........2.2.BBBBBBBB...B...BBBWWWWW2.2.BBBBBBBBBB2.BBBBBBBBG",
	"GBBBBBBBB2...........2.2.BBBBBBBB4..B4..BBBBBBBB2.2.BBBBBBBBBB2.BBBBBBBBG",
	"GBBBBBBBBx...........2.2.BBBBBBBB...B...BBBBBBWW2.2.WWWBBBBBBBx.BBBBBBBBG",
	"G3.3.3.3.y.3.3.3.3.3.y.y.3.3.3.3.E......3.3.3.3.y.y.3.3.3.3.3.y.3.3.3.3.G",
	"G.......................................................................G",
	"G.......................................................................G",
	"GBBBBBBBBc.BBBBBBBBBBw...BBBBBBBB...B...BBBBBBBBw...BBBBBBBBBBc.BBBBBBBBG",
	"G3.3.3.3.y.3.3.3.3.3.y.y.3.3.3.3........3.3.3.3.y.y.3.3.3.3.3.y.3.3.3.3.G",
	"G.......................................................................G",
	"G.......................................................................G",
	"GBBBBBBBBb.BBBBBBBBBB2.2.BBBBBBBB4..B4..BBBBBBBB2.2.H.........b.WWWWWWWWW",
	"GBBBBBBBB2.BBBBBBBBBB2.2.BBBBBBBB...B...BBBBBBBB2.2...........2.WWWWWWWWW",
	"GBBBBBBBB2.BBBBBBBBBB2.2.BBBBBBBB4..B4..BBBBBBBB2.2...........2.BBBBBBBBG",
	"GBBBBBBBBx.BBBBBBBBBBx.x.BBBBBBBB...B...BBBBBBBBx.x...........x.BBWWWWWWW",
	"G1111111zC.a11111111zC.C.a1111111d..ed..1111111zC.C.a11111111zC.a1111111G",
	"G.......................................................................G",
	"G1111111zC.a11111111zC.C.a1111111d...d..1111111zC.C.a11111111zC.a1111111G",
	"G.......................................................................G",
	"GBBBBBBBBb.BBBBBBBBBBb.b.BBBBBBBB4..B4..BBBBBBBBb.b.BBBBBBBBBBb.BBBBBBBBG",
	"GO...O...2.BBBBBBBBBB2.2.BBBBBBBB...B...BBBBBBBB2.2.BBBBBBBBBB2.BBBBBBBBG",
	"G..P.....2.BBBBBBBBBB2.2.BBBBBBBB4..B4..BBBBBBBB2.2.BBBBBBBBBB2.BBBBBBBBG",
	"GBBBBBBBBx.BBBBBBBBBBx.x.BBBBBBBB...B...BBBBBBBBx.x.BBBBBBBBBBx.BBBBBBBBG",
	"G1111111zC.a11111111zC.C.a111111zd..vd..a111111zC.C.a11111111zC.a1111111G",
	"G.......................................................................G",
	"GBBBBBBBBb.BBBBBBBBBBb.b.BBBBBBBB4..B4..BBBBBBBBb.b.BBBBBBBBBBb.BBBBBBBBG",
	"GGGGGGGGGGGGGGGGGGGGGGGGGGGGGGGGGGGGGGGGGGGGGGGGGGGGGGGGGGGGGGGGGGGGGGGGG"
]
